111111111111111
1P01000000100C1
1001C0101010101
10010C101010101
1001C01C1000101
10000C101111101
111111100000001
1000C1001111111
1C0100000C0W0E1
111111111111111
